1110011111111111111
1110101111111111111
1110110111111111111
1100111111111111111
1110111011111111111
1110111101111111111
1110111110111111111
1110111111011111111
1110111111101111111
1110111111110111111
1110111111111011111
1110111111111101111
1110111111111110111
1110111111111111011
1110111111111111101
1110111111111111110
1010111111111111111
1111001111111111111
1111010111111111111
1101011111111111111
0110111111111111111
1111011011111111111
1111011101111111111
1111011110111111111
1111011111011111111
1111011111101111111
1111011111110111111
1111011111111011111
1111011111111101111
1111011111111110111
1111011111111111011
1111011111111111101
1111011111111111110
1011011111111111111
1111100111111111111
1101101111111111111
1111101011111111111
1111101101111111111
1111101110111111111
1111101111011111111
1111101111101111111
1111101111110111111
1111101111111011111
1111101111111101111
1111101111111110111
1111101111111111011
1111101111111111101
1111101111111111110
1101110111111111111
0011111111111111111
1111110011111111111
1101111011111111111
1111110101111111111
0101111111111111111
1111110110111111111
1101111101111111111
1111110111011111111
1111110111101111111
1111110111110111111
1111110111111011111
1111110111111101111
1111110111111110111
1111110111111111011
1111110111111111101
1111110111111111110
1101111110111111111
1101111111011111111
1101111111101111111
1101111111110111111
1101111111111011111
1101111111111101111
1101111111111110111
1101111111111111011
1101111111111111101
1101111111111111110
1111111001111111111
0111011111111111111
1111111010111111111
1111111011011111111
1111111011101111111
1111111011110111111
1111111011111011111
1111111011111101111
1111111011111110111
1111111011111111011
1111111011111111101
1111111011111111110
1111111100111111111
1111111101011111111
1111111101101111111
1111111101110111111
1111111101111011111
1111111101111101111
1111111101111110111
1111111101111111011
1111111101111111101
1111111101111111110
1111111110011111111
1111111110101111111
1111111110110111111
1111111110111011111
1111111110111101111
1111111110111110111
1111111110111111011
1111111110111111101
1111111110111111110
1111111111001111111
1111111111010111111
1111111111011011111
1111111111011101111
1111111111011110111
1111111111011111011
1111111111011111101
1111111111011111110
1111111111100111111
1111111111101011111
1111111111101101111
1111111111101110111
1111111111101111011
1111111111101111101
1111111111101111110
1111111111110011111
1111111111110101111
1111111111110110111
1111111111110111011
1111111111110111101
1111111111110111110
1111111111111001111
1111111111111010111
1111111111111011011
1111111111111011101
1111111111111011110
1111111111111100111
1111111111111101011
1111111111111101101
1111111111111101110
1111111111111110011
1111111111111110101
1111111111111110110
1111111111111111001
1111111111111111010
1111111111111111100
1001111111111111111
1011101111111111111
0111101111111111111
1011110111111111111
1011111011111111111
1011111101111111111
1011111110111111111
1011111111011111111
1011111111101111111
1011111111110111111
1011111111111011111
1011111111111101111
1011111111111110111
1011111111111111011
1011111111111111101
1011111111111111110
0111110111111111111
0111111011111111111
0111111101111111111
0111111110111111111
0111111111011111111
0111111111101111111
0111111111110111111
0111111111111011111
0111111111111101111
0111111111111110111
0111111111111111011
0111111111111111101
0111111111111111110
