1110111111111111111
1101111111111111111
0111111111111111111
1011111111111111111
1111011111111111111
1111101111111111111
1111110111111111111
1111111011111111111
1111111101111111111
1111111110111111111
1111111111011111111
1111111111101111111
1111111111110111111
1111111111111011111
1111111111111101111
1111111111111110111
1111111111111111011
1111111111111111101
1111111111111111110
